{
  "levels": [
    {
      "id": 0,
      "levelData": [
        1, 1, 1, 1, 1, 1, 1, 1, 1,
        1, 0, 0, 0, 0, 0, 0, 0, 1,
        1, 0, 1, 1, 0, 0, 0, 0, 1,
        1, 0, 1, 1, 0, 0, 0, 0, 1,
        1, 0, 0, 0, 0, 1, 0, 0, 1,
        1, 0, 0, 0, 0, 1, 1, 0, 1,
        1, 0, 2, 0, 0, 0, 1, 0, 1,
        1, 0, 0, 0, 0, 0, 0, 0, 1,
        1, 1, 1, 1, 1, 1, 1, 1, 1
      ]
    },
    {
      "id": 1,
      "levelData": [
        1, 1, 1, 1, 1, 1, 1, 1, 1,
        1, 0, 2, 0, 0, 0, 0, 0, 1,
        1, 0, 0, 0, 0, 0, 0, 0, 1,
        1, 1, 1, 1, 0, 0, 0, 0, 1,
        1, 1, 0, 0, 0, 0, 0, 0, 1,
        1, 1, 0, 1, 0, 0, 0, 0, 1,
        1, 1, 0, 1, 0, 0, 0, 0, 1,
        1, 1, 1, 1, 0, 0, 0, 0, 1,
        1, 1, 1, 1, 1, 1, 1, 1, 1
      ]
    }
  ]
}